4,4,4,4,4,4,4,4,4,4,4,4,4,4,4,4,4,4,4,4,4,4,4,4
4,0,0,0,0,0,0,0,0,0,0,0,0,0,0,0,0,0,0,0,0,0,0,4
4,0,0,0,0,0,0,0,0,0,0,0,0,3,3,3,0,0,0,0,0,0,0,4
4,0,0,0,0,0,0,0,0,0,7,0,0,0,0,0,0,0,0,0,0,0,0,4
4,0,0,0,0,0,0,0,0,0,0,0,0,0,0,0,0,0,0,0,0,0,0,4
4,3,3,3,3,3,3,3,3,3,3,0,0,0,0,0,0,0,0,0,0,0,0,4
4,10,0,0,0,0,0,0,0,0,0,0,0,0,0,0,0,0,0,8,0,0,0,4
4,10,0,0,0,0,0,0,0,0,0,0,0,0,0,0,0,0,0,3,3,3,0,4
4,10,0,0,0,0,0,0,0,7,0,0,0,0,0,0,0,7,0,0,0,0,0,4
4,10,0,0,3,3,0,0,10,0,0,0,0,0,0,0,5,5,5,5,0,0,0,4
4,10,0,0,0,0,0,0,10,0,0,0,0,0,0,0,0,0,0,0,0,0,0,4
4,3,3,3,3,0,0,3,3,0,0,0,0,3,3,3,3,0,0,0,0,0,0,4
4,0,0,0,0,0,0,0,0,0,0,0,0,0,0,0,0,0,0,0,0,0,0,4
4,0,0,0,5,5,5,5,5,0,0,0,0,0,0,0,0,0,0,0,0,0,0,4
4,0,0,0,2,2,2,2,2,2,3,3,3,0,0,0,0,0,0,0,0,0,0,4
4,0,0,12,0,0,10,0,0,0,0,0,0,8,0,0,0,7,0,0,0,0,0,4
4,0,0,3,3,3,10,0,0,0,0,0,0,0,0,0,0,0,0,0,0,0,0,4
4,0,0,0,0,0,10,0,0,0,8,5,0,0,0,0,0,0,0,0,0,0,0,4
4,13,0,0,0,0,10,0,7,0,3,3,3,0,0,0,0,10,0,0,8,0,0,4
4,3,3,3,3,3,3,3,3,0,0,0,0,10,0,0,0,10,0,0,0,0,0,4
4,0,0,0,0,0,7,0,0,0,0,0,0,10,0,0,0,10,0,0,0,0,0,4
4,0,0,0,0,0,10,0,0,7,0,0,0,10,0,0,0,3,0,0,0,0,0,4
4,0,0,0,0,3,3,3,3,3,3,3,3,10,0,0,0,3,3,3,3,3,0,4
4,0,0,0,0,0,0,0,0,0,0,0,0,10,0,0,0,0,0,0,0,0,0,4
4,0,0,0,0,0,0,0,0,0,0,7,0,10,0,0,0,0,0,0,0,0,0,4
4,3,3,3,3,3,3,3,3,3,3,3,3,10,3,3,3,0,0,0,0,0,0,4
4,0,0,0,0,0,0,0,0,0,0,0,0,10,0,0,0,0,0,0,0,0,0,4
4,0,0,0,0,0,0,0,0,0,0,0,0,10,0,0,0,0,0,0,0,0,0,4
4,3,3,3,3,3,3,3,3,7,3,3,3,10,0,0,0,0,0,0,0,0,0,4
4,8,8,0,0,0,0,0,0,0,0,0,0,0,8,8,0,0,0,0,0,0,0,4 
4,3,3,3,3,3,3,3,3,3,3,3,3,3,3,3,3,3,3,3,3,3,9,4 
4,4,4,4,4,4,4,4,4,4,4,4,4,4,4,4,4,4,4,4,4,4,4,4
